1111111111
1C0000P001
100E000001
1000000001
1111111111
