1111111111111111111111111
1E0000000C00000C00000C001
1010010101101001000010101
1010001101010000100010101
1P00000C00C0000C1000000C1
1000000000C00000100000001
1000CC0000000000100000001
1011111100011111100000001
1CCCCCC10001CCCCCC0000CC1
1111111111111111111111111
