111111
1P00E1
100001
10C001
111111
